[console_scripts]
add-user-DFC = LHCbDIRAC.ConfigurationSystem.scripts.add_user_DFC:main
dirac-admin-grid-weather = LHCbDIRAC.Interfaces.scripts.dirac_admin_grid_weather:main
dirac-architecture = LHCbDIRAC.Core.scripts.dirac_architecture:main
dirac-bookkeeping-CLI = LHCbDIRAC.BookkeepingSystem.scripts.dirac_bookkeeping_CLI:main
dirac-bookkeeping-decays-path = LHCbDIRAC.BookkeepingSystem.scripts.dirac_bookkeeping_decays_path:main
dirac-bookkeeping-eventtype-mgt-insert = LHCbDIRAC.BookkeepingSystem.scripts.dirac_bookkeeping_eventtype_mgt_insert:main
dirac-bookkeeping-eventtype-mgt-update = LHCbDIRAC.BookkeepingSystem.scripts.dirac_bookkeeping_eventtype_mgt_update:main
dirac-bookkeeping-file-metadata = LHCbDIRAC.BookkeepingSystem.scripts.dirac_bookkeeping_file_metadata:main
dirac-bookkeeping-file-path = LHCbDIRAC.BookkeepingSystem.scripts.dirac_bookkeeping_file_path:main
dirac-bookkeeping-filetypes-insert = LHCbDIRAC.BookkeepingSystem.scripts.dirac_bookkeeping_filetypes_insert:main
dirac-bookkeeping-filetypes-list = LHCbDIRAC.BookkeepingSystem.scripts.dirac_bookkeeping_filetypes_list:main
dirac-bookkeeping-fix-luminosity = LHCbDIRAC.BookkeepingSystem.scripts.dirac_bookkeeping_fix_luminosity:main
dirac-bookkeeping-genXMLCatalog = LHCbDIRAC.BookkeepingSystem.scripts.dirac_bookkeeping_genXMLCatalog:main
dirac-bookkeeping-get-conditions = LHCbDIRAC.BookkeepingSystem.scripts.dirac_bookkeeping_get_conditions:main
dirac-bookkeeping-get-file-ancestors = LHCbDIRAC.BookkeepingSystem.scripts.dirac_bookkeeping_get_file_ancestors:main
dirac-bookkeeping-get-file-descendants = LHCbDIRAC.BookkeepingSystem.scripts.dirac_bookkeeping_get_file_descendants:main
dirac-bookkeeping-get-file-sisters = LHCbDIRAC.BookkeepingSystem.scripts.dirac_bookkeeping_get_file_sisters:main
dirac-bookkeeping-get-files = LHCbDIRAC.BookkeepingSystem.scripts.dirac_bookkeeping_get_files:main
dirac-bookkeeping-get-processing-passes = LHCbDIRAC.BookkeepingSystem.scripts.dirac_bookkeeping_get_processing_passes:main
dirac-bookkeeping-get-run-ranges = LHCbDIRAC.BookkeepingSystem.scripts.dirac_bookkeeping_get_run_ranges:main
dirac-bookkeeping-get-runsWithAGivenDate = LHCbDIRAC.BookkeepingSystem.scripts.dirac_bookkeeping_get_runsWithAGivenDate:main
dirac-bookkeeping-get-stats = LHCbDIRAC.BookkeepingSystem.scripts.dirac_bookkeeping_get_stats:main
dirac-bookkeeping-get-tck = LHCbDIRAC.BookkeepingSystem.scripts.dirac_bookkeeping_get_tck:main
dirac-bookkeeping-getdataquality-runs = LHCbDIRAC.BookkeepingSystem.scripts.dirac_bookkeeping_getdataquality_runs:main
dirac-bookkeeping-job-info = LHCbDIRAC.BookkeepingSystem.scripts.dirac_bookkeeping_job_info:main
dirac-bookkeeping-job-input-output = LHCbDIRAC.BookkeepingSystem.scripts.dirac_bookkeeping_job_input_output:main
dirac-bookkeeping-prod4path = LHCbDIRAC.BookkeepingSystem.scripts.dirac_bookkeeping_prod4path:main
dirac-bookkeeping-production-files = LHCbDIRAC.BookkeepingSystem.scripts.dirac_bookkeeping_production_files:main
dirac-bookkeeping-production-information = LHCbDIRAC.BookkeepingSystem.scripts.dirac_bookkeeping_production_information:main
dirac-bookkeeping-production-jobs = LHCbDIRAC.BookkeepingSystem.scripts.dirac_bookkeeping_production_jobs:main
dirac-bookkeeping-productions-summary = LHCbDIRAC.BookkeepingSystem.scripts.dirac_bookkeeping_productions_summary:main
dirac-bookkeeping-rejection-stats = LHCbDIRAC.BookkeepingSystem.scripts.dirac_bookkeeping_rejection_stats:main
dirac-bookkeeping-run-files = LHCbDIRAC.BookkeepingSystem.scripts.dirac_bookkeeping_run_files:main
dirac-bookkeeping-run-information = LHCbDIRAC.BookkeepingSystem.scripts.dirac_bookkeeping_run_information:main
dirac-bookkeeping-set-visibility = LHCbDIRAC.BookkeepingSystem.scripts.dirac_bookkeeping_set_visibility:main
dirac-bookkeeping-setdataquality = LHCbDIRAC.BookkeepingSystem.scripts.dirac_bookkeeping_setdataquality:main
dirac-bookkeeping-setdataquality-files = LHCbDIRAC.BookkeepingSystem.scripts.dirac_bookkeeping_setdataquality_files:main
dirac-bookkeeping-setdataquality-run = LHCbDIRAC.BookkeepingSystem.scripts.dirac_bookkeeping_setdataquality_run:main
dirac-bookkeeping-setdataquality-run-processing-pass = LHCbDIRAC.BookkeepingSystem.scripts.dirac_bookkeeping_setdataquality_run_processing_pass:main
dirac-bookkeeping-simulationconditions-insert = LHCbDIRAC.BookkeepingSystem.scripts.dirac_bookkeeping_simulationconditions_insert:main
dirac-bookkeeping-simulationconditions-list = LHCbDIRAC.BookkeepingSystem.scripts.dirac_bookkeeping_simulationconditions_list:main
dirac-dms-add-file = LHCbDIRAC.DataManagementSystem.scripts.dirac_dms_add_file:main
dirac-dms-add-transformation = LHCbDIRAC.DataManagementSystem.scripts.dirac_dms_add_transformation:main
dirac-dms-check-bkk2fc = LHCbDIRAC.DataManagementSystem.scripts.dirac_dms_check_bkk2fc:main
dirac-dms-check-directory-content = LHCbDIRAC.DataManagementSystem.scripts.dirac_dms_check_directory_content:main
dirac-dms-check-directory-integrity = LHCbDIRAC.DataManagementSystem.scripts.dirac_dms_check_directory_integrity:main
dirac-dms-check-fc2bkk = LHCbDIRAC.DataManagementSystem.scripts.dirac_dms_check_fc2bkk:main
dirac-dms-check-fc2se = LHCbDIRAC.DataManagementSystem.scripts.dirac_dms_check_fc2se:main
dirac-dms-check-file-integrity = LHCbDIRAC.DataManagementSystem.scripts.dirac_dms_check_file_integrity:main
dirac-dms-check-inputdata = LHCbDIRAC.DataManagementSystem.scripts.dirac_dms_check_inputdata:main
dirac-dms-check-se = LHCbDIRAC.DataManagementSystem.scripts.dirac_dms_check_se:main
dirac-dms-chown-directory = LHCbDIRAC.DataManagementSystem.scripts.dirac_dms_chown_directory:main
dirac-dms-get-file = LHCbDIRAC.DataManagementSystem.scripts.dirac_dms_get_file:main
dirac-dms-lfn-accessURL = LHCbDIRAC.DataManagementSystem.scripts.dirac_dms_lfn_accessURL:main
dirac-dms-lfn-metadata = LHCbDIRAC.DataManagementSystem.scripts.dirac_dms_lfn_metadata:main
dirac-dms-lfn-replicas = LHCbDIRAC.DataManagementSystem.scripts.dirac_dms_lfn_replicas:main
dirac-dms-list-directory = LHCbDIRAC.DataManagementSystem.scripts.dirac_dms_list_directory:main
dirac-dms-pfn-exists = LHCbDIRAC.DataManagementSystem.scripts.dirac_dms_pfn_exists:main
dirac-dms-pfn-metadata = LHCbDIRAC.DataManagementSystem.scripts.dirac_dms_pfn_metadata:main
dirac-dms-register-bk2fc = LHCbDIRAC.DataManagementSystem.scripts.dirac_dms_register_bk2fc:main
dirac-dms-remove-disk-replicas = LHCbDIRAC.DataManagementSystem.scripts.dirac_dms_remove_disk_replicas:main
dirac-dms-remove-files = LHCbDIRAC.DataManagementSystem.scripts.dirac_dms_remove_files:main
dirac-dms-remove-replicas = LHCbDIRAC.DataManagementSystem.scripts.dirac_dms_remove_replicas:main
dirac-dms-replica-stats = LHCbDIRAC.DataManagementSystem.scripts.dirac_dms_replica_stats:main
dirac-dms-replicate-lfn = LHCbDIRAC.DataManagementSystem.scripts.dirac_dms_replicate_lfn:main
dirac-dms-replicate-to-run-destination = LHCbDIRAC.DataManagementSystem.scripts.dirac_dms_replicate_to_run_destination:main
dirac-dms-scan-popularity = LHCbDIRAC.DataManagementSystem.scripts.dirac_dms_scan_popularity:main
dirac-dms-set-problematic-files = LHCbDIRAC.DataManagementSystem.scripts.dirac_dms_set_problematic_files:main
dirac-dms-storage-usage-summary = LHCbDIRAC.DataManagementSystem.scripts.dirac_dms_storage_usage_summary:main
dirac-lhcb-analyse-XML-summary = LHCbDIRAC.Core.scripts.dirac_lhcb_analyse_XML_summary:main
dirac-lhcb-fix-file-guid = LHCbDIRAC.Core.scripts.dirac_lhcb_fix_file_guid:main
dirac-lhcb-get-root-guid = LHCbDIRAC.Core.scripts.dirac_lhcb_get_root_guid:main
dirac-lhcb-mc-eventtype-info = LHCbDIRAC.Core.scripts.dirac_lhcb_mc_eventtype_info:main
dirac-loop = LHCbDIRAC.Core.scripts.dirac_loop:main
dirac-production-action = LHCbDIRAC.Interfaces.scripts.dirac_production_action:main
dirac-production-application-summary = LHCbDIRAC.Interfaces.scripts.dirac_production_application_summary:main
dirac-production-change-status = LHCbDIRAC.Interfaces.scripts.dirac_production_change_status:main
dirac-production-check-ancestors = LHCbDIRAC.TransformationSystem.scripts.dirac_production_check_ancestors:main
dirac-production-check-descendants = LHCbDIRAC.TransformationSystem.scripts.dirac_production_check_descendants:main
dirac-production-file-status = LHCbDIRAC.Interfaces.scripts.dirac_production_file_status:main
dirac-production-file-summary = LHCbDIRAC.Interfaces.scripts.dirac_production_file_summary:main
dirac-production-job-get-id = LHCbDIRAC.Interfaces.scripts.dirac_production_job_get_id:main
dirac-production-job-info = LHCbDIRAC.Interfaces.scripts.dirac_production_job_info:main
dirac-production-job-summary = LHCbDIRAC.Interfaces.scripts.dirac_production_job_summary:main
dirac-production-list-id = LHCbDIRAC.Interfaces.scripts.dirac_production_list_id:main
dirac-production-logging-info = LHCbDIRAC.Interfaces.scripts.dirac_production_logging_info:main
dirac-production-mc-extend = LHCbDIRAC.Interfaces.scripts.dirac_production_mc_extend:main
dirac-production-progress = LHCbDIRAC.Interfaces.scripts.dirac_production_progress:main
dirac-production-remove-output = LHCbDIRAC.TransformationSystem.scripts.dirac_production_remove_output:main
dirac-production-runjoblocal = LHCbDIRAC.TransformationSystem.scripts.dirac_production_runjoblocal:main
dirac-production-set-agent-type = LHCbDIRAC.Interfaces.scripts.dirac_production_set_agent_type:main
dirac-production-set-runs = LHCbDIRAC.TransformationSystem.scripts.dirac_production_set_runs:main
dirac-production-shifter = LHCbDIRAC.ProductionManagementSystem.scripts.dirac_production_shifter:main
dirac-production-site-summary = LHCbDIRAC.Interfaces.scripts.dirac_production_site_summary:main
dirac-production-summary = LHCbDIRAC.Interfaces.scripts.dirac_production_summary:main
dirac-production-verify-outputdata = LHCbDIRAC.TransformationSystem.scripts.dirac_production_verify_outputdata:main
dirac-test-plugin = LHCbDIRAC.TransformationSystem.scripts.dirac_test_plugin:main
dirac-transformation-add-files = LHCbDIRAC.TransformationSystem.scripts.dirac_transformation_add_files:main
dirac-transformation-archive = LHCbDIRAC.TransformationSystem.scripts.dirac_transformation_archive:main
dirac-transformation-clean = LHCbDIRAC.TransformationSystem.scripts.dirac_transformation_clean:main
dirac-transformation-debug = LHCbDIRAC.TransformationSystem.scripts.dirac_transformation_debug:main
dirac-transformation-flush-runs = LHCbDIRAC.TransformationSystem.scripts.dirac_transformation_flush_runs:main
dirac-transformation-information = LHCbDIRAC.TransformationSystem.scripts.dirac_transformation_information:main
dirac-transformation-remove-files = LHCbDIRAC.TransformationSystem.scripts.dirac_transformation_remove_files:main
dirac-transformation-reset-files = LHCbDIRAC.TransformationSystem.scripts.dirac_transformation_reset_files:main
dirac-transformation-set-run-destination = LHCbDIRAC.TransformationSystem.scripts.dirac_transformation_set_run_destination:main
dirac-transformation-targets = LHCbDIRAC.TransformationSystem.scripts.dirac_transformation_targets:main
dirac-transformation-update-derived = LHCbDIRAC.TransformationSystem.scripts.dirac_transformation_update_derived:main
lhcb-CheckStalledService = LHCbDIRAC.Core.scripts.lhcb_CheckStalledService:main
lhcb-proxy-init = LHCbDIRAC.Core.scripts.lhcb_proxy_init:main
lhcb-restart-agent-service = LHCbDIRAC.Core.scripts.lhcb_restart_agent_service:main

[dirac]
metadata = LHCbDIRAC:extension_metadata

