[console_scripts]
fermipy-analyze-extension = fermipy.jobs.target_extension:AnalyzeExtension.main
fermipy-analyze-extension-sg = fermipy.jobs.target_extension:AnalyzeExtension_SG.main
fermipy-analyze-roi = fermipy.jobs.target_analysis:AnalyzeROI.main
fermipy-analyze-roi-sg = fermipy.jobs.target_analysis:AnalyzeROI_SG.main
fermipy-analyze-sed = fermipy.jobs.target_analysis:AnalyzeSED.main
fermipy-analyze-sed-sg = fermipy.jobs.target_analysis:AnalyzeSED_SG.main
fermipy-assemble-model = fermipy.diffuse.gt_assemble_model:AssembleModel.main
fermipy-assemble-model-chain = fermipy.diffuse.gt_assemble_model:AssembleModel.main
fermipy-assemble-model-sg = fermipy.diffuse.gt_assemble_model:AssembleModel_SG.main
fermipy-astroserver = fermipy.scripts.astroserver:main
fermipy-catalog-comp-chain = fermipy.diffuse.diffuse_analysis:CatalogCompChain.main
fermipy-clone-configs = fermipy.scripts.clone_configs:main
fermipy-cluster-sources = fermipy.scripts.cluster_sources:main
fermipy-coadd = fermipy.scripts.coadd:main
fermipy-coadd-split = fermipy.diffuse.gt_coadd_split:CoaddSplit.main
fermipy-coadd-split-sg = fermipy.diffuse.gt_coadd_split:CoaddSplit_SG.main
fermipy-collect-sed = fermipy.jobs.target_collect:CollectSED.main
fermipy-collect-sed-sg = fermipy.jobs.target_collect:CollectSED_SG.main
fermipy-collect-sources = fermipy.scripts.collect_sources:main
fermipy-copy-base-roi = fermipy.jobs.target_sim:CopyBaseROI.main
fermipy-copy-base-roi-sg = fermipy.jobs.target_sim:CopyBaseROI_SG.main
fermipy-diffuse-analysis = fermipy.diffuse.diffuse_analysis:DiffuseAnalysisChain.main
fermipy-diffuse-comp-chain = fermipy.diffuse.diffuse_analysis:DiffuseCompChain.main
fermipy-dispatch = fermipy.scripts.dispatch:main
fermipy-file-archive = fermipy.jobs.file_archive:main_browse
fermipy-fit-diffuse = fermipy.diffuse.fitting:FitDiffuse.main
fermipy-fit-diffuse-sg = fermipy.diffuse.fitting:FitDiffuse_SG.main
fermipy-flux-sensitivity = fermipy.scripts.flux_sensitivity:main
fermipy-gather-srcmaps = fermipy.scripts.gather_srcmaps:main
fermipy-gather-srcmaps-sg = fermipy.diffuse.job_library:GatherSrcmaps_SG.main
fermipy-gethdutype = fermipy.scripts.gethdutype:main
fermipy-gtexcube2-sg = fermipy.diffuse.job_library:Gtexpcube2_SG.main
fermipy-gtexpcube2wcs-sg = fermipy.diffuse.solar:Gtexpcube2wcs_SG.main
fermipy-gtexphpsun-sg = fermipy.diffuse.solar:Gtexphpsun_SG.main
fermipy-gtltsum-sg = fermipy.diffuse.job_library:Gtltsum_sg.main
fermipy-gtsuntemp-sg = fermipy.diffuse.solar:Gtsuntemp_SG.main
fermipy-healview = fermipy.scripts.HEALview:main
fermipy-healview-sg = fermipy.diffuse.job_library:Healview_SG.main
fermipy-init-model = fermipy.diffuse.gt_assemble_model:InitModel.main
fermipy-intensity-map = fermipy.scripts.intensity_map:main
fermipy-job-archive = fermipy.jobs.job_archive:main_browse
fermipy-make-wmap = fermipy.scripts.make_weights_map:main
fermipy-merge-srcmaps = fermipy.diffuse.gt_merge_srcmaps:GtMergeSrcmaps.main
fermipy-merge-srcmaps-sg = fermipy.diffuse.gt_merge_srcmaps:MergeSrcmaps_SG.main
fermipy-merit-response = fermipy.scripts.merit_response:main
fermipy-merit-skimmer = fermipy.scripts.merit_skimmer:main
fermipy-plot-castro = fermipy.jobs.target_plotting:PlotCastro.main
fermipy-plot-castro-sg = fermipy.jobs.target_plotting:PlotCastro_SG.main
fermipy-plot-sed-summary-bands = fermipy.jobs.target_plotting:PlotSEDSummaryBands.main
fermipy-plot-sed-summary-bands-sg = fermipy.jobs.target_plotting:PlotSEDSummaryBands_SG.main
fermipy-prepare-targets = fermipy.jobs.prepare_targets:PrepareTargets.main
fermipy-preprocess = fermipy.scripts.preprocess_data:main
fermipy-quick-analysis = fermipy.scripts.quickanalysis:main
fermipy-random-dir-gen = fermipy.jobs.target_sim:RandomDirGen.main
fermipy-random-dir-gen-sg = fermipy.jobs.target_sim:RandomDirGen_SG.main
fermipy-residual-cr = fermipy.diffuse.residual_cr:ResidualCR.main
fermipy-residual-cr-chain = fermipy.diffuse.residual_cr:ResidualCRChain.main
fermipy-residual-cr-sg = fermipy.diffuse.residual_cr:ResidualCR_SG.main
fermipy-run-tempo = fermipy.scripts.run_tempo:main
fermipy-select = fermipy.scripts.select_data:main
fermipy-simulate-roi = fermipy.jobs.target_sim:SimulateROI.main
fermipy-simulate-roi-sg = fermipy.jobs.target_sim:SimulateROI_SG.main
fermipy-split-and-bin = fermipy.diffuse.gt_split_and_bin:SplitAndBin.main
fermipy-split-and-bin-chain = fermipy.diffuse.gt_split_and_bin:SplitAndBinChain.main
fermipy-split-and-bin-sg = fermipy.diffuse.gt_split_and_bin:SplitAndBin_SG.main
fermipy-split-and-mktime = fermipy.diffuse.gt_split_and_mktime:SplitAndMktime.main
fermipy-split-and-mktime-chain = fermipy.diffuse.gt_split_and_mktime:SplitAndMktimeChain.main
fermipy-split-and-mktime-sg = fermipy.diffuse.gt_split_and_mktime:SplitAndMktime_SG.main
fermipy-srcmaps-catalog = fermipy.diffuse.gt_srcmaps_catalog:GtSrcmapsCatalog.main
fermipy-srcmaps-catalog-sg = fermipy.diffuse.gt_srcmaps_catalog:SrcmapsCatalog_SG.main
fermipy-srcmaps-diffuse = fermipy.diffuse.gt_srcmap_partial:GtSrcmapsDiffuse.main
fermipy-srcmaps-diffuse-sg = fermipy.diffuse.gt_srcmap_partial:SrcmapsDiffuse_SG.main
fermipy-sum-ring-gasmaps-sg = fermipy.diffuse.job_library:SumRings_SG.main
fermipy-sunmoon-chain = fermipy.diffuse.solar:SunMoonChain.main
fermipy-validate = fermipy.scripts.validate:main
fermipy-vstack = fermipy.scripts.vstack_images:main
fermipy-vstack-diffuse-sg = fermipy.diffuse.job_library:Vstack_SG.main
fermipy-wcsview = fermipy.scripts.WCSview:main

