[console_scripts]
SCCalculateBitcoinBlockHash = ScriptCollection.core:SCCalculateBitcoinBlockHash_cli
SCChangeHashOfProgram = ScriptCollection.core:SCChangeHashOfProgram_cli
SCCreateEmptyFileWithSpecificSize = ScriptCollection.core:SCCreateEmptyFileWithSpecificSize_cli
SCCreateHashOfAllFiles = ScriptCollection.core:SCCreateHashOfAllFiles_cli
SCCreateISOFileWithObfuscatedFiles = ScriptCollection.core:SCCreateISOFileWithObfuscatedFiles_cli
SCCreateRelease = ScriptCollection.core:SCCreateRelease_cli
SCDebCreateInstallerRelease = ScriptCollection.core:SCDebCreateInstallerRelease_cli
SCDotNetBuild = ScriptCollection.core:SCDotNetBuild_cli
SCDotNetBuildExecutableAndRunTests = ScriptCollection.core:SCDotNetBuildExecutableAndRunTests_cli
SCDotNetBuildNugetAndRunTests = ScriptCollection.core:SCDotNetBuildNugetAndRunTests_cli
SCDotNetCreateExecutableRelease = ScriptCollection.core:SCDotNetCreateExecutableRelease_cli
SCDotNetCreateNugetRelease = ScriptCollection.core:SCDotNetCreateNugetRelease_cli
SCDotNetReference = ScriptCollection.core:SCDotNetReference_cli
SCDotNetReleaseNuget = ScriptCollection.core:SCDotNetReleaseNuget_cli
SCDotNetRunTests = ScriptCollection.core:SCDotNetRunTests_cli
SCDotNetsign = ScriptCollection.core:SCDotNetsign_cli
SCFileIsAvailable = ScriptCollection.core:SCFileIsAvailable_cli
SCFilenameObfuscator = ScriptCollection.core:SCFilenameObfuscator_cli
SCGenerateSnkFiles = ScriptCollection.core:SCGenerateSnkFiles_cli
SCGenerateThumbnail = ScriptCollection.core:SCGenerateThumbnail_cli
SCKeyboardDiagnosis = ScriptCollection.core:SCKeyboardDiagnosis_cli
SCMergePDFs = ScriptCollection.core:SCMergePDFs_cli
SCObfuscateFilesFolder = ScriptCollection.core:SCObfuscateFilesFolder_cli
SCOrganizeLinesInFile = ScriptCollection.core:SCOrganizeLinesInFile_cli
SCPythonBuild = ScriptCollection.core:SCPythonBuild_cli
SCPythonBuildWheelAndRunTests = ScriptCollection.core:SCPythonBuildWheelAndRunTests_cli
SCPythonCreateWheelRelease = ScriptCollection.core:SCPythonCreateWheelRelease_cli
SCPythonReleaseWheel = ScriptCollection.core:SCPythonReleaseWheel_cli
SCPythonRunTests = ScriptCollection.core:SCPythonRunTests_cli
SCReplaceSubstringsInFilenames = ScriptCollection.core:SCReplaceSubstringsInFilenames_cli
SCSearchInFiles = ScriptCollection.core:SCSearchInFiles_cli
SCShow2FAAsQRCode = ScriptCollection.core:SCShow2FAAsQRCode_cli
SCShowMissingFiles = ScriptCollection.core:SCShowMissingFiles_cli
SCUpdateNugetpackagesInCsharpProject = ScriptCollection.core:UpdateNugetpackagesInCsharpProject_cli
SCUploadFile = ScriptCollection.core:SCUploadFile_cli

