[console_scripts]
lbn-ansi2html = LbNightlyTools.Scripts._entry_points:ansi2html
lbn-build = LbNightlyTools.Scripts.Build:run
lbn-build-legacy = LbNightlyTools.Scripts.Build:run
lbn-build-log-to-html = LbNightlyTools.Scripts._entry_points:build_log_to_html
lbn-check-config = LbNightlyTools.Configuration:check_config
lbn-check-preconditions = LbNightlyTools.Scripts._entry_points:check_preconditions
lbn-checkout = LbNightlyTools.Scripts.Checkout:run
lbn-checkout-legacy = LbNightlyTools.Scripts.Checkout:run
lbn-collect-build-logs = LbNightlyTools.Scripts._entry_points:collect_build_logs
lbn-enabled-slots = LbNightlyTools.Scripts._entry_points:enabled_slots
lbn-gen-release-config = LbNightlyTools.Scripts._entry_points:gen_release_config
lbn-generate-compatspec = LbNightlyTools.Scripts._entry_points:generate_compatspec
lbn-generate-do0spec = LbNightlyTools.Scripts._entry_points:generate_do0spec
lbn-generate-extspec = LbNightlyTools.Scripts._entry_points:generate_extspec
lbn-generate-genericspec = LbNightlyTools.Scripts._entry_points:generate_genericspec
lbn-generate-lbscriptsspec = LbNightlyTools.Scripts._entry_points:generate_lbscriptsspec
lbn-generate-metaspec = LbNightlyTools.Scripts._entry_points:generate_metaspec
lbn-generate-spec = LbNightlyTools.Scripts._entry_points:generate_spec
lbn-get-new-refs = LbNightlyTools.GetNightlyRefs:main
lbn-gitlab-mr = LbNightlyTools.Scripts.GitlabMR:main
lbn-index = LbNightlyTools.Scripts._entry_points:index
lbn-install = LbNightlyTools.Scripts._entry_points:install
lbn-list-platforms = LbNightlyTools.Scripts._entry_points:list_platforms
lbn-preconditions = LbNightlyTools.Scripts._entry_points:preconditions
lbn-release-poll = LbNightlyTools.Scripts._entry_points:release_poll
lbn-release-trigger = LbNightlyTools.Scripts._entry_points:release_trigger
lbn-reschedule-tests = LbNightlyTools.Scripts._entry_points:reschedule_tests
lbn-rpm = LbNightlyTools.Scripts._entry_points:rpm
lbn-rpm-validator = LbNightlyTools.Scripts._entry_points:rpm_validator
lbn-slots-by-deployment = LbNightlyTools.Scripts._entry_points:slots_by_deployment
lbn-test = LbNightlyTools.Scripts.Test:run
lbn-test-legacy = LbNightlyTools.Scripts.Test:run
lbn-test-poll = LbNightlyTools.Scripts._entry_points:test_poll
lbp-check-periodic-tests = LbPeriodicTools._entry_points:check_periodic_tests
lbp-check-periodic-tests-msg = LbPeriodicTools._entry_points:check_periodic_tests_msg
lbpr-get-command = LbPR._entry_points:get_command
lbq-builddone = LbNightlyTools.Scripts._entry_points:lbq_builddone
lbq-buildnotif = LbNightlyTools.Scripts._entry_points:lbq_buildnotif
lbq-getteststorun = LbNightlyTools.Scripts._entry_points:lbq_getteststorun
lbq-requesttest = LbNightlyTools.Scripts._entry_points:lbq_requesttest

