

[console_scripts]
rattail = rattail.commands:main
rattail-dev = rattail.commands.dev:main
trainwreck = rattail.trainwreck.commands:main

[gui_scripts]
rattailw = rattail.commands:main

[rattail.commands]
backup = rattail.commands.backup:Backup
bouncer = rattail.commands.core:EmailBouncer
checkdb = rattail.commands.core:CheckDatabase
clonedb = rattail.commands.core:CloneDatabase
datasync = rattail.commands.core:DataSync
date-organize = rattail.commands.core:DateOrganize
execute-batch = rattail.commands.batch:ExecuteBatch
export-csv = rattail.commands.importing:ExportCSV
export-rattail = rattail.commands.importing:ExportRattail
filemon = rattail.commands.core:FileMonitorCommand
import-csv = rattail.commands.importing:ImportCSV
import-ifps = rattail.commands.importing:ImportIFPS
import-rattail = rattail.commands.importing:ImportRattail
import-sample = rattail.commands.importing:ImportSampleData
import-versions = rattail.commands.importing:ImportVersions
make-appdir = rattail.commands.core:MakeAppDir
make-batch = rattail.commands.batch:MakeBatch
make-config = rattail.commands.core:MakeConfig
make-user = rattail.commands.core:MakeUser
make-uuid = rattail.commands.core:MakeUUID
populate-batch = rattail.commands.batch:PopulateBatch
problems = rattail.commands.problems:Problems
purge-batches = rattail.commands.batch:PurgeBatches
purge-versions = rattail.commands.importing:PurgeVersions
refresh-batch = rattail.commands.batch:RefreshBatch
run-n-mail = rattail.commands.core:RunAndMail
runsql = rattail.commands.core:RunSQL
update-costs = rattail.commands.products:UpdateCosts
upgrade = rattail.commands.core:Upgrade
version-check = rattail.commands.importing:VersionCheck

[rattail_dev.commands]
new-batch = rattail.commands.dev:NewBatch

[rattail.config.extensions]
rattail.db = rattail.db:ConfigExtension
rattail.trainwreck = rattail.trainwreck.config:TrainwreckConfig

[rattail.features]
new-report = rattail.features.newreport:NewReportFeature
new-table = rattail.features.newtable:NewTableFeature

[rattail.reports]
customer_mailing = rattail.reporting.customer_mailing:CustomerMailing

[rattail.sil.column_providers]
rattail = rattail.sil.columns:provide_columns

[rattail.vendors.catalogs.parsers]
rattail.contrib.dutchvalley = rattail.contrib.vendors.catalogs.dutchvalley:DutchValleyCatalogParser
rattail.contrib.equalexchange = rattail.contrib.vendors.catalogs.equalexchange:EqualExchangeCatalogParser
rattail.contrib.kehe = rattail.contrib.vendors.catalogs.kehe:KeheCatalogParser
rattail.contrib.lotuslight = rattail.contrib.vendors.catalogs.lotuslight:LotusLightCatalogParser
rattail.contrib.unfi = rattail.contrib.vendors.catalogs.unfi:UNFICatalogParser
rattail.contrib.unfi.2 = rattail.contrib.vendors.catalogs.unfi:UNFICatalogParser2

[rattail.vendors.invoices.parsers]
rattail.contrib.alberts = rattail.contrib.vendors.invoices.alberts:AlbertsInvoiceParser
rattail.contrib.kehe = rattail.contrib.vendors.invoices.kehe:KeheInvoiceParser
rattail.contrib.unfi = rattail.contrib.vendors.invoices.unfi:UnfiInvoiceParser

[trainwreck.commands]
export-trainwreck = rattail.trainwreck.commands:ExportTrainwreck
import-trainwreck = rattail.trainwreck.commands:ImportTrainwreck
